###########
#         #
#    .    #
#  ###  ### 
#  # $$ # #
#  # @  # #
#  #    # #
#  ###  # #
#         #
#   .     #
###########
